1111111
1PC0001
10100E1
1100001
1001001
1110011
1111111
