1111111
1101001
10100C1
1E1PD11
1000101
1000001
1111111