1111111111111111111111
10D1P0EC001001000110D1
1CCD0000D0000000000001
1D0D101000C00000010001
1000C1D000000C00D00101
1C000C0001000010100001
100100C1D001000D111C01
1001010001000001000001
1001100000100000000101
1000000000000010000101
1111000000100000110001
1000101001000000000101
1000100000010000100111
1000100000100000010001
1000000000000000000001
1000000011010000001001
1000000000000010000001
1100100000000100000001
1001100000000000000001
1001001000110000001001
1001000000000000010001
1111111111111111111111