111111
100001
1P0011
1C1E01
111011
100001
111111
