11111111111
1001EP00001
110000C0C01
1C0000000C1
10000001001
10000100001
10100001001
10010001001
10001000001
10001000001
11111111111
