111111111111111111111111111
1C0000E0D00010000000P000001
1000C0001010000000000000D01
10C000100100D00000000100011
1010D1000C00010000001001001
100C0010D000000000011100001
1D00C0000000000100000000101
100010000D10000010110000001
110010DC0000000000000000001
10000000D000010000110C01001
1D00000000000000C1000000001
100000C000D0000000000000001
100000010D01C00000000001001
1D11C0000100001000000000001
10CD00000100000000000000001
1DC000000011000001010010001
100C000D0100011100000000001
1C010D001001000100010000001
1001000C00000000100D0100001
100D010C0000000000000000001
100D1000000001C100011100001
111111111111111111111111111
