1111111111111111111
100000E0C0000P1D001
11001100100110D0D01
10C0000000001011001
10C0000010010011001
10110000C0010100101
1C00000000010001101
101001000001C000001
1000000000100000001
1001010000001000011
11010000100C0000001
1000C00000000000011
1000010000C10000101
111001C000001000001
11C0000000000000001
101000000C101001001
1000C00010001100001
1000000100001000001
1111111111111111111
