1111111111111111111
1P0000E0C0000000001
1010000000100000001
1000010000000100001
1010000100000000001
1000000000000000001
1001000000000001001
1101000001000000001
1000000000000000001
1000000000000000001
1000100000001000001
1010000000000000101
1000000000000000011
1000000000001100001
1000000000000000101
1000000000000000001
1000000000000000001
1000000000000001001
1111111111111111111
