1111111111111111111
1E1P00000C0100D00D1
1000D01010001010101
100010C000000000001
101C000000001000001
10000000000000C0101
100100C100000000101
101000000100010C001
10000C0100000000001
1100000100010C00001
10C0000010000000001
1100C00001000000001
101000000C001000001
10C0000110000010001
100C000101000000101
1000001000000100101
1001100001000010001
1000000000100000101
1111111111111111111
