11111111111111111111111111111111111111111
10PC00DE000000000000C0000000000C001010001
1000000000D00000C000000000000000000000001
100000000000D0000100001000000000010000001
1000000D000000000000000100000000000000101
1D000000000001011000000000000000000000101
10D00000000000000000000000100000000000001
1001100D000000000000000000000000100010001
100D0000000010000000000000000000010000001
10000000D00010000000000000000000000000001
100010000000000000000000000000100D0001001
10000D00000000000000000000010000000000001
100000000D0000000000001000001000000000101
10000D00000000000000000000000000010000001
1000000000000100000000000000D000000000001
1D000000000000000110000000000000000000001
11000001000000D00000000010000000000000001
1D000000010000000000000000000000000000001
100000D0000000000000000000001000000010001
1000000000000000000000001000001000D000101
11D00000000000100000001000000100000000001
10000000000D00100000000000000000000000001
1D000000000000001000000000000000001000001
100D0000000000000001000000000000000000001
1000000D000000000010000000000000000100101
1000D000000100000000000000000000000000001
10000D00000000010000000000010000000000001
1D100000000000000000000000000000000000001
1000D010010000000000000000000000000000001
10000D00000000000000010000100000000010001
1000000D010000000000000000000000000000001
10000000000000000000001000000100000010001
10000000000000000000000000000010000000001
10000000000010000000000000000000000000001
10011000000000000010000000000000000000001
10001000100000000000000000000000000000001
10000000000000000000000010000000000000001
10000000000001000000000000000000000000001
10000000000000000000100000100000000000001
10000000000000001000000000000001000000001
11111111111111111111111111111111111111111
