111111111111111111111111111
100P0C00C00C0000000000C0001
1E0000000000000000000000011
100000000000001000001000001
101000000000000000000000001
100000000000000000000000001
100000100000000000000000001
100000000010010000000000001
100000000000000000000000001
100000000000000000001000001
100000000000110100000000001
100000000000000000000000001
100000000010000000000000001
100000000000000000000100001
101000000000000000000000001
100000100000000000000000001
101000000000000001000000001
100000000000001000000010001
100000000000000010000000001
100010000000000000000000001
100000000000000000000000001
100000000000000000000000001
100000000000000000000000001
100000000000000000010100001
100001000000000100000000001
100000000000000000000000101
111111111111111111111111111
