11111111111
10EC0000101
1P0C00000C1
1C010000001

10000000001
10000000001
10100100001
10000100001
10001011011
11111111111
