11111111111111111
11D0C000P00E00001
1C000001000000011
10C10D00000000001
10C10000000101001
10010000D00000001
110D000C100101001
100000D10C0101001
10100100000C00D01
101CD000010000101
1110C0000000000D1
1001C000000001011
10C001000D0001001
10000001000000011
10001100C10D00001
10010000010C01001
11111111111111111
