1111111111111111
1010PD00000000E1
10011000CD000001
100C01D000101011
1D000000000C0001
1000C0000D000001
10D00000C0000001
1000C00000000001
1C00000011000001
10100D00001100C1
1D00000C00100001
1000000000000001
1100000000010001
110C110001010101
1000000000010001
1111111111111111
