1111111111111111
11P000D00E001011
1D0001000000C001
11101C0000010101
10000C0000000001
1C01000000D00001
1C0001D001001001
1D100000000C1001
10C00001D0010001
1D000001000C1011
11C0000000000001
101C1D0000000001
1000000001000111
1010000000011001
1001000000000011
1111111111111111
