1111111111111111111
1P0D0010101E0000101
1C1100D000001010101
100000100C10D000001
1D000110000000C0011
100100CD00000000001
1000D00000100000001
11000001000010C0011
100000DC00000000001
10D01000000000C1001
10D110C010000010001
1D000000C0000100101
1011100C01D00101011
101C1D0000000001001
1C0001D000000100011
1D00000000000000001
110C000000000001001
1001D0C000000010001
1000D11000100000001
11100D01C0000000001
10D1100000100000001
1111111111111111111
