1111111111111
11E1000C00001
1000000P00001
110010C000001
1C10010001011
1010000001001
10010101000C1
10100001C0001
11C0000001101
1101000010C11
1000C01001001
10C1011000001
10010C0010001
1111111111111
