111111111111
1C0010E0P001
100000100001
100000000001
100000000001
100000000001
101000001011
101000100001
100000000001
100000000101
100000000001
111111111111
