1111111111111
11P10E011C111
1010001000001
10C0000000001
100C000010001
1000C10010001
1000C00000101
10000001C0101
1C00000000001
1000C01000001
1C10100010001
100C000110101
1111111111111
