111111111111
1C0PDE100011
100001110C01
1000D0101C01
1C00D0000011
1000C1D00001
100100D0C011
10000001C001
1C00100000D1
10000C000101
10001C001101
111111111111
