11111111111
10CP00E0C01
100C0000C01
10000000001
10000000001
11000100001
10000100001
10100000001
10100100001
10000000001
11111111111
