11111111111111111
110C01E01D0011001
10000C101D0011001
101C10P111D010011
10C011100000101D1
1D0C0000000001001
1C0D0000000000001
1D0C0010101000101
101DC001110000001
1000C000001100D01
11D00000101C00011
10000000000000011
10001100000000011
10010110110101001
10000010000000001
10010010011000001
11111111111111111
